1111111111111
1C01000000001
1000000C00001
10C0000000001
1000011111001
10PP110E00001
1111111111111