1111111111111
1001000000001
1000000000001
1000000000001
1000011111001
10P0110E00001
1111111111111