1111111111111
10010000000C1
1000000C00001
1000000000001
1000011111001
1P00110E0C001
1111111111111