1111111111111
1CJ10T00000C1
1000000C00001
10C000JT000T1
1000011111001
10P0110E000J1
1111111111111