1111111111111
10J100000J001
100000000C001
10C0000000001
1000011111001
1P0011E00C0T1
1111111111111