1111111111111
1C01000000001
1000000C000M1
10C0000M00001
1000011111001
10P0110E000M1
1111111111111